time,total,free,available,dirty,anon,mapped,pageTable,vmallocTotal,vmallocUsed,own_VmRSS,own_RssAnon,own_RssFile,own_VmPTE,Node0_total,Node0_free,Node0_used,Node0_dirty,Node0_anon,Node0_mapped,Node0_pageTable,Node1_total,Node1_free,Node1_used,Node1_dirty,Node1_anon,Node1_mapped,Node1_pageTable
2025-07-30T18:17:04.607754,394700376,372567816,391624076,508,218172,133700,4068,34359738367,251472,16936,7168,9768,112,196531936,183477516,13054420,436,207284,33592,3648,198168440,189090300,9078140,72,10888,100108,420
2025-07-30T18:17:05.608191,394700376,371893716,391067576,2572,578052,133956,7460,34359738367,261520,16936,7168,9768,112,196531936,182819860,13712076,2500,561840,33516,4620,198168440,189073856,9094584,72,16212,100440,2840
2025-07-30T18:17:06.608762,394700376,371515344,391020476,2592,623708,134316,7808,34359738367,261520,16936,7168,9768,112,196531936,182441324,14090612,2520,607252,33876,4968,198168440,189074020,9094420,72,16456,100440,2840
2025-07-30T18:17:07.609310,394700376,371517756,391364084,628,188264,124216,8920,34359738367,261536,16936,7168,9768,112,196531936,182453876,14078060,556,170984,23776,5212,198168440,189063880,9104560,72,17280,100440,3708
2025-07-30T18:17:08.609848,394700376,371287476,391374736,1700,196308,134424,6976,34359738367,261536,16936,7168,9768,112,196531936,182228924,14303012,1628,177780,33984,4116,198168440,189058552,9109888,72,18528,100440,2860
2025-07-30T18:17:09.610369,394700376,371047828,391390924,1712,196304,134424,6976,34359738367,261536,16936,7168,9768,112,196531936,181988644,14543292,1640,177776,33984,4116,198168440,189059184,9109256,72,18528,100440,2860
2025-07-30T18:17:10.610904,394700376,378171684,391401284,704,185440,122740,6500,34359738367,261200,16936,7168,9768,112,196531936,188471412,8060524,632,168892,22316,3660,198168440,189700272,8468168,72,16548,100424,2840
2025-07-30T18:17:11.611452,394700376,388513924,391411528,704,185440,122740,6500,34359738367,261200,16936,7168,9768,112,196531936,192499508,4032428,632,168892,22316,3660,198168440,196016936,2151504,72,16548,100424,2840
2025-07-30T18:17:12.611987,394700376,393265032,391749736,608,194540,207712,8912,34359738367,262640,16936,7168,9768,112,196531936,195608928,923008,532,173520,64788,4848,198168440,197656104,512336,76,21020,142928,4064
2025-07-30T18:17:13.612524,394700376,392911728,391550748,608,194800,518396,8904,34359738367,262624,16936,7168,9768,112,196531936,195460408,1071528,532,173592,220088,4856,198168440,197451320,717120,76,21208,298328,4048
2025-07-30T18:17:14.614768,394700376,392704896,391416020,620,194800,662980,8904,34359738367,262608,16936,7168,9768,112,196531936,195357904,1174032,532,173592,292400,4856,198168440,197346992,821448,88,21208,370580,4048
2025-07-30T18:17:15.615797,394700376,392714120,391426052,632,194704,664676,8904,34359738367,262608,16936,7168,9768,112,196531936,195367128,1164808,532,173496,293232,4856,198168440,197346992,821448,100,21208,371444,4048
2025-07-30T18:17:16.622765,394700376,392726608,391438540,632,194704,664676,8904,34359738367,262608,16936,7168,9768,112,196531936,195379364,1152572,532,173496,293232,4856,198168440,197347244,821196,100,21208,371444,4048
2025-07-30T18:17:17.623828,394700376,392748300,391460232,636,194704,664676,8904,34359738367,262608,16936,7168,9768,112,196531936,195395164,1136772,536,173496,293232,4856,198168440,197353136,815304,100,21208,371444,4048
2025-07-30T18:17:18.624866,394700376,392770252,391482184,636,194704,664676,8904,34359738367,262608,16936,7168,9768,112,196531936,195410048,1121888,536,173496,293232,4856,198168440,197360204,808236,100,21208,371444,4048
2025-07-30T18:17:19.625915,394700376,392789108,391501040,640,194704,664676,8904,34359738367,262608,16936,7168,9768,112,196531936,195424868,1107068,536,173496,293232,4856,198168440,197364240,804200,104,21208,371444,4048
2025-07-30T18:17:20.627012,394700376,392816384,391528424,636,194708,664676,8904,34359738367,262608,16936,7168,9768,112,196531936,195444276,1087660,532,173500,293232,4856,198168440,197372108,796332,104,21208,371444,4048
2025-07-30T18:17:21.628042,394700376,392840888,391552928,636,194708,664676,8904,34359738367,262608,16936,7168,9768,112,196531936,195461020,1070916,532,173500,293232,4856,198168440,197379868,788572,104,21208,371444,4048
2025-07-30T18:17:22.630776,394700376,392763536,391475708,640,194136,664712,9240,34359738367,262608,16936,7168,9768,112,196531936,195430816,1101120,536,173276,293252,5036,198168440,197332720,835720,104,20860,371460,4204
2025-07-30T18:17:23.634773,394700376,392783176,391495592,644,194716,664676,8892,34359738367,262608,16936,7168,9768,112,196531936,195444052,1087884,536,173520,293232,4856,198168440,197339124,829316,108,21196,371444,4036
2025-07-30T18:17:24.635805,394700376,392808568,391520984,644,194716,664676,8892,34359738367,262608,16936,7168,9768,112,196531936,195462540,1069396,536,173520,293232,4856,198168440,197346028,822412,108,21196,371444,4036
2025-07-30T18:17:25.636842,394700376,392824780,391537196,648,194720,664676,8892,34359738367,262608,16936,7168,9768,112,196531936,195475792,1056144,540,173524,293232,4856,198168440,197348988,819452,108,21196,371444,4036
2025-07-30T18:17:26.637904,394700376,392844752,391557168,656,194720,664676,8892,34359738367,262608,16936,7168,9768,112,196531936,195488628,1043308,548,173524,293232,4856,198168440,197356124,812316,108,21196,371444,4036
2025-07-30T18:17:27.642773,394700376,392862476,391574892,672,194720,664676,8892,34359738367,262608,16936,7168,9768,112,196531936,195501220,1030716,552,173524,293232,4856,198168440,197361256,807184,120,21196,371444,4036
2025-07-30T18:17:28.643808,394700376,392872460,391585044,684,194820,664676,8892,34359738367,262608,16936,7168,9768,112,196531936,195508664,1023272,556,173556,293232,4856,198168440,197363796,804644,128,21264,371444,4036
2025-07-30T18:17:29.644846,394700376,392883524,391596108,684,194820,664676,8892,34359738367,262608,16936,7168,9768,112,196531936,195516128,1015808,556,173556,293232,4856,198168440,197367396,801044,128,21264,371444,4036
2025-07-30T18:17:30.645885,394700376,392886168,391598752,684,194820,664676,8892,34359738367,262608,16936,7168,9768,112,196531936,195521144,1010792,556,173556,293232,4856,198168440,197365024,803416,128,21264,371444,4036
2025-07-30T18:17:31.650774,394700376,392889540,391602124,688,194820,664676,8892,34359738367,262608,16936,7168,9768,112,196531936,195524516,1007420,556,173556,293232,4856,198168440,197365024,803416,132,21264,371444,4036
2025-07-30T18:17:32.651823,394700376,392855744,391568412,468,194816,664588,9276,34359738367,262608,16936,7168,9768,112,196531936,195522560,1009376,348,173556,293184,5056,198168440,197333184,835256,120,21260,371404,4220
2025-07-30T18:17:33.652901,394700376,392862356,391575080,472,194820,664676,8896,34359738367,262608,16936,7168,9768,112,196531936,195527592,1004344,348,173556,293232,4864,198168440,197334764,833676,124,21264,371444,4032
2025-07-30T18:17:34.653951,394700376,392870304,391583028,472,194820,664676,8896,34359738367,262608,16936,7168,9768,112,196531936,195533064,998872,348,173556,293232,4864,198168440,197337240,831200,124,21264,371444,4032
2025-07-30T18:17:35.658770,394700376,392881584,391594352,396,194852,664676,8896,34359738367,262608,16936,7168,9768,112,196531936,195539064,992872,276,173588,293232,4864,198168440,197342520,825920,120,21264,371444,4032
2025-07-30T18:17:36.659819,394700376,392889220,391601988,404,194852,664676,8896,34359738367,262608,16936,7168,9768,112,196531936,195541512,990424,284,173588,293232,4864,198168440,197347708,820732,120,21264,371444,4032
2025-07-30T18:17:37.660882,394700376,392894804,391607572,404,194860,664676,8896,34359738367,262608,16936,7168,9768,112,196531936,195543552,988384,284,173596,293232,4864,198168440,197351252,817188,120,21264,371444,4032
2025-07-30T18:17:38.661908,394700376,392900924,391613692,404,194860,664676,8896,34359738367,262608,16936,7168,9768,112,196531936,195545620,986316,284,173596,293232,4864,198168440,197355304,813136,120,21264,371444,4032
2025-07-30T18:17:39.666777,394700376,392902532,391615300,420,194860,664676,8896,34359738367,262608,16936,7168,9768,112,196531936,195546492,985444,288,173596,293232,4864,198168440,197356040,812400,132,21264,371444,4032
2025-07-30T18:17:40.667856,394700376,392903932,391616700,356,194860,664676,8896,34359738367,262608,16936,7168,9768,112,196531936,195547500,984436,224,173596,293232,4864,198168440,197356432,812008,132,21264,371444,4032
2025-07-30T18:17:41.668910,394700376,392908468,391621236,360,194860,664676,8896,34359738367,262608,16936,7168,9768,112,196531936,195549264,982672,224,173596,293232,4864,198168440,197359204,809236,136,21264,371444,4032
2025-07-30T18:17:42.669978,394700376,392847752,391560572,364,194384,664288,9076,34359738367,262576,16936,7168,9768,112,196531936,195500644,1031292,228,173308,293012,4952,198168440,197347108,821332,136,21076,371276,4124
2025-07-30T18:17:43.674768,394700376,392849512,391562560,184,194924,664676,8900,34359738367,262576,16936,7168,9768,112,196531936,195500648,1031288,92,173564,293232,4860,198168440,197348864,819576,92,21360,371444,4040
2025-07-30T18:17:44.675835,394700376,392855808,391568856,216,194924,664676,8900,34359738367,262576,16936,7168,9768,112,196531936,195503524,1028412,120,173564,293232,4860,198168440,197352284,816156,96,21360,371444,4040
2025-07-30T18:17:45.676892,394700376,392859712,391572760,52,194924,664676,8900,34359738367,262576,16936,7168,9768,112,196531936,195505484,1026452,48,173564,293232,4860,198168440,197354228,814212,4,21360,371444,4040
2025-07-30T18:17:46.677954,394700376,392865184,391578232,64,194924,664676,8900,34359738367,262576,16936,7168,9768,112,196531936,195508720,1023216,52,173564,293232,4860,198168440,197356464,811976,12,21360,371444,4040
2025-07-30T18:17:47.682768,394700376,392875188,391588236,76,194924,664676,8900,34359738367,262576,16936,7168,9768,112,196531936,195515556,1016380,64,173564,293232,4860,198168440,197359632,808808,12,21360,371444,4040
2025-07-30T18:17:48.683829,394700376,392881620,391594668,80,194924,664676,8900,34359738367,262576,16936,7168,9768,112,196531936,195520100,1011836,68,173564,293232,4860,198168440,197361520,806920,12,21360,371444,4040
2025-07-30T18:17:49.684989,394700376,392885984,391599032,88,194924,664676,8900,34359738367,262576,16936,7168,9768,112,196531936,195524188,1007748,72,173564,293232,4860,198168440,197361796,806644,16,21360,371444,4040
2025-07-30T18:17:50.686052,394700376,392890348,391603396,76,194924,664676,8900,34359738367,262576,16936,7168,9768,112,196531936,195526536,1005400,60,173564,293232,4860,198168440,197363812,804628,16,21360,371444,4040
2025-07-30T18:17:51.690777,394700376,392892776,391605824,92,194924,664676,8900,34359738367,262576,16936,7168,9768,112,196531936,195528208,1003728,64,173564,293232,4860,198168440,197364568,803872,28,21360,371444,4040
2025-07-30T18:17:52.691835,394700376,392863452,391576500,92,194892,664676,8920,34359738367,262592,16936,7168,9768,112,196531936,195510224,1021712,64,173556,293232,4872,198168440,197353228,815212,28,21336,371444,4048
2025-07-30T18:17:53.692872,394700376,392865004,391578176,100,194932,664676,8896,34359738367,262544,16936,7168,9768,112,196531936,195510512,1021424,64,173568,293232,4856,198168440,197354492,813948,36,21364,371444,4040
2025-07-30T18:17:54.693916,394700376,392866728,391579932,104,194932,664676,8896,34359738367,262544,16936,7168,9768,112,196531936,195511732,1020204,64,173568,293232,4856,198168440,197354996,813444,40,21364,371444,4040
2025-07-30T18:17:55.698771,394700376,392868492,391581696,120,194932,664676,8896,34359738367,262544,16936,7168,9768,112,196531936,195512740,1019196,72,173568,293232,4856,198168440,197355752,812688,48,21364,371444,4040
2025-07-30T18:17:56.699810,394700376,392873488,391586692,120,194932,664676,8896,34359738367,262544,16936,7168,9768,112,196531936,195515308,1016628,72,173568,293232,4856,198168440,197358180,810260,48,21364,371444,4040
2025-07-30T18:17:57.700868,394700376,392875968,391589172,124,195000,664676,8896,34359738367,262544,16936,7168,9768,112,196531936,195515812,1016124,76,173636,293232,4856,198168440,197360156,808284,48,21364,371444,4040
2025-07-30T18:17:58.701929,394700376,392880456,391593660,140,195000,664676,8896,34359738367,262544,16936,7168,9768,112,196531936,195517844,1014092,88,173636,293232,4856,198168440,197362612,805828,52,21364,371444,4040
2025-07-30T18:17:59.706779,394700376,392887700,391600904,148,195000,664676,8896,34359738367,262544,16936,7168,9768,112,196531936,195522560,1009376,96,173636,293232,4856,198168440,197365140,803300,52,21364,371444,4040
2025-07-30T18:18:00.707837,394700376,392889912,391603116,148,195000,664676,8896,34359738367,262544,16936,7168,9768,112,196531936,195523916,1008020,96,173636,293232,4856,198168440,197365996,802444,52,21364,371444,4040
2025-07-30T18:18:01.708882,394700376,392892528,391605732,148,195000,664676,8896,34359738367,262544,16936,7168,9768,112,196531936,195525176,1006760,96,173636,293232,4856,198168440,197367352,801088,52,21364,371444,4040
2025-07-30T18:18:02.709943,394700376,392814000,391527204,148,196020,664676,9016,34359738367,262576,16936,7168,9768,112,196531936,195494240,1037696,96,174140,293232,4924,198168440,197319760,848680,52,21880,371444,4092
2025-07-30T18:18:03.714773,394700376,392817520,391530892,160,195000,664676,8900,34359738367,262544,16936,7168,9768,112,196531936,195496240,1035696,96,173668,293232,4852,198168440,197321280,847160,64,21332,371444,4048
2025-07-30T18:18:04.715819,394700376,392819412,391532784,164,195000,664676,8900,34359738367,262544,16936,7168,9768,112,196531936,195497752,1034184,100,173668,293232,4852,198168440,197321660,846780,64,21332,371444,4048
2025-07-30T18:18:05.716876,394700376,392824672,391538044,168,195000,664676,8900,34359738367,262544,16936,7168,9768,112,196531936,195500060,1031876,100,173668,293232,4852,198168440,197324612,843828,68,21332,371444,4048
2025-07-30T18:18:06.717935,394700376,392833380,391546752,160,195000,664676,8900,34359738367,262544,16936,7168,9768,112,196531936,195504304,1027632,92,173668,293232,4852,198168440,197329076,839364,68,21332,371444,4048
2025-07-30T18:18:07.719099,394700376,392841688,391555060,160,195000,664676,8900,34359738367,262544,16936,7168,9768,112,196531936,195508292,1023644,92,173668,293232,4852,198168440,197333396,835044,68,21332,371444,4048
2025-07-30T18:18:08.722777,394700376,392852620,391565992,160,195032,664676,8900,34359738367,262544,16936,7168,9768,112,196531936,195512912,1019024,92,173700,293232,4852,198168440,197339708,828732,68,21332,371444,4048
2025-07-30T18:18:09.723930,394700376,392862320,391575692,168,195032,664676,8900,34359738367,262544,16936,7168,9768,112,196531936,195517432,1014504,100,173700,293232,4852,198168440,197344888,823552,68,21332,371444,4048
2025-07-30T18:18:10.725077,394700376,392869572,391582944,180,195032,664676,8900,34359738367,262544,16936,7168,9768,112,196531936,195520324,1011612,108,173700,293232,4852,198168440,197349248,819192,72,21332,371444,4048
2025-07-30T18:18:11.726237,394700376,392873148,391586520,180,195032,664676,8900,34359738367,262544,16936,7168,9768,112,196531936,195521536,1010400,108,173700,293232,4852,198168440,197351612,816828,72,21332,371444,4048
2025-07-30T18:18:12.730775,394700376,392823208,391536580,184,195088,664676,8928,34359738367,262544,16936,7168,9768,112,196531936,195515900,1016036,108,173740,293232,4868,198168440,197307308,861132,76,21348,371444,4060
2025-07-30T18:18:13.731920,394700376,392797744,391511224,192,195152,664676,8948,34359738367,262528,16936,7168,9768,112,196531936,195498744,1033192,112,173760,293232,4880,198168440,197299000,869440,80,21392,371444,4068
2025-07-30T18:18:14.733082,394700376,392801148,391514628,200,195152,664676,8896,34359738367,262528,16936,7168,9768,112,196531936,195500060,1031876,112,173760,293232,4852,198168440,197301088,867352,88,21392,371444,4044
2025-07-30T18:18:15.734293,394700376,392807100,391520580,152,195152,664676,8896,34359738367,262528,16936,7168,9768,112,196531936,195502772,1029164,84,173760,293232,4852,198168440,197304328,864112,68,21392,371444,4044
2025-07-30T18:18:16.738780,394700376,392816032,391529512,164,195152,664676,8896,34359738367,262528,16936,7168,9768,112,196531936,195506992,1024944,92,173760,293232,4852,198168440,197309040,859400,72,21392,371444,4044
2025-07-30T18:18:17.742774,394700376,392823792,391537276,132,195152,664676,8896,34359738367,262528,16936,7168,9768,112,196531936,195509984,1021952,76,173760,293232,4852,198168440,197313808,854632,56,21392,371444,4044
2025-07-30T18:18:18.743917,394700376,392834216,391547700,136,195152,664676,8896,34359738367,262528,16936,7168,9768,112,196531936,195514656,1017280,76,173760,293232,4852,198168440,197319560,848880,60,21392,371444,4044
2025-07-30T18:18:19.745033,394700376,392841692,391555176,144,195152,664676,8896,34359738367,262528,16936,7168,9768,112,196531936,195517392,1014544,84,173760,293232,4852,198168440,197324300,844140,60,21392,371444,4044
2025-07-30T18:18:20.746163,394700376,392847212,391560696,144,195152,664676,8896,34359738367,262528,16936,7168,9768,112,196531936,195520484,1011452,84,173760,293232,4852,198168440,197326728,841712,60,21392,371444,4044
2025-07-30T18:18:21.750773,394700376,392851544,391565028,88,195152,664676,8896,34359738367,262528,16936,7168,9768,112,196531936,195522808,1009128,52,173760,293232,4852,198168440,197328736,839704,36,21392,371444,4044
2025-07-30T18:18:22.751949,394700376,392834316,391547800,92,195152,664676,8896,34359738367,262544,16936,7168,9768,112,196531936,195514480,1017456,56,173760,293232,4852,198168440,197319836,848604,36,21392,371444,4044
2025-07-30T18:18:23.753183,394700376,392834004,391547560,100,195152,664676,8900,34359738367,262512,16936,7168,9768,112,196531936,195513244,1018692,64,173744,293232,4852,198168440,197320760,847680,36,21408,371444,4048
2025-07-30T18:18:24.754343,394700376,392836056,391549612,100,195152,664676,8900,34359738367,262512,16936,7168,9768,112,196531936,195514504,1017432,64,173744,293232,4852,198168440,197321552,846888,36,21408,371444,4048
2025-07-30T18:18:25.758782,394700376,392839836,391553392,100,195152,664676,8900,34359738367,262512,16936,7168,9768,112,196531936,195516520,1015416,64,173744,293232,4852,198168440,197323316,845124,36,21408,371444,4048
2025-07-30T18:18:26.759955,394700376,392844372,391557928,124,195152,664676,8900,34359738367,262512,16936,7168,9768,112,196531936,195519292,1012644,68,173744,293232,4852,198168440,197325080,843360,56,21408,371444,4048
2025-07-30T18:18:27.761095,394700376,392847648,391561216,112,195152,664676,8900,34359738367,262512,16936,7168,9768,112,196531936,195521056,1010880,68,173744,293232,4852,198168440,197326592,841848,44,21408,371444,4048
2025-07-30T18:18:28.762228,394700376,392850492,391564116,124,195192,664676,8900,34359738367,262512,16936,7168,9768,112,196531936,195522640,1009296,72,173784,293232,4852,198168440,197327852,840588,52,21408,371444,4048
2025-07-30T18:18:29.766775,394700376,392854300,391567924,124,195192,664676,8900,34359738367,262512,16936,7168,9768,112,196531936,195524936,1007000,72,173784,293232,4852,198168440,197329364,839076,52,21408,371444,4048
2025-07-30T18:18:30.767914,394700376,392857832,391571468,136,195192,664676,8900,34359738367,262512,16936,7168,9768,112,196531936,195526700,1005236,84,173784,293232,4852,198168440,197331132,837308,52,21408,371444,4048
2025-07-30T18:18:31.769071,394700376,392861348,391574984,140,195192,664676,8900,34359738367,262512,16936,7168,9768,112,196531936,195528212,1003724,88,173784,293232,4852,198168440,197333136,835304,52,21408,371444,4048
2025-07-30T18:18:32.770214,394700376,392864132,391577780,108,195204,664676,9052,34359738367,262448,16936,7168,9768,112,196531936,195530484,1001452,68,173772,293232,4932,198168440,197333648,834792,40,21432,371444,4120
2025-07-30T18:18:33.774772,394700376,392847904,391561656,112,195296,664676,8956,34359738367,262464,16936,7168,9768,112,196531936,195513324,1018612,72,173828,293232,4884,198168440,197334580,833860,40,21468,371444,4072
2025-07-30T18:18:34.775927,394700376,392850972,391564784,116,195196,664676,8896,34359738367,262464,16936,7168,9768,112,196531936,195514880,1017056,76,173784,293232,4856,198168440,197336092,832348,40,21412,371444,4040
2025-07-30T18:18:35.777123,394700376,392854968,391568780,116,195200,664676,8896,34359738367,262464,16936,7168,9768,112,196531936,195517496,1014440,76,173784,293232,4856,198168440,197337472,830968,40,21416,371444,4040
2025-07-30T18:18:36.778313,394700376,392861076,391574888,116,195200,664676,8896,34359738367,262464,16936,7168,9768,112,196531936,195521840,1010096,76,173784,293232,4856,198168440,197339236,829204,40,21416,371444,4040
2025-07-30T18:18:37.782780,394700376,392865000,391578812,116,195200,664676,8896,34359738367,262464,16936,7168,9768,112,196531936,195524252,1007684,72,173784,293232,4856,198168440,197340748,827692,44,21416,371444,4040
2025-07-30T18:18:38.783914,394700376,392869468,391583280,124,195200,664676,8896,34359738367,262464,16936,7168,9768,112,196531936,195527688,1004248,72,173784,293232,4856,198168440,197341780,826660,52,21416,371444,4040
2025-07-30T18:18:39.785089,394700376,392873816,391587628,128,195232,664676,8896,34359738367,262464,16936,7168,9768,112,196531936,195531280,1000656,72,173816,293232,4856,198168440,197342536,825904,56,21416,371444,4040
2025-07-30T18:18:40.786210,394700376,392876844,391590656,140,195232,664676,8896,34359738367,262464,16936,7168,9768,112,196531936,195532792,999144,80,173816,293232,4856,198168440,197344052,824388,60,21416,371444,4040
2025-07-30T18:18:41.790775,394700376,392880688,391594500,140,195236,664676,8896,34359738367,262464,16936,7168,9768,112,196531936,195535124,996812,80,173820,293232,4856,198168440,197345564,822876,60,21416,371444,4040
2025-07-30T18:18:42.791930,394700376,392880692,391594508,148,195316,664676,9004,34359738367,262480,16936,7168,9768,112,196531936,195536384,995552,84,173864,293232,4904,198168440,197344308,824132,64,21452,371444,4100
2025-07-30T18:18:43.793122,394700376,392867280,391581172,160,196100,664804,8860,34359738367,262448,16936,7168,9768,112,196531936,195523304,1008632,92,174172,293292,4836,198168440,197343976,824464,68,21928,371512,4024
2025-07-30T18:18:44.794288,394700376,392868796,391582688,160,195324,664676,8888,34359738367,262448,16936,7168,9768,112,196531936,195524568,1007368,92,173840,293232,4860,198168440,197344228,824212,68,21484,371444,4028
2025-07-30T18:18:45.798781,394700376,392873332,391587228,124,195324,664676,8888,34359738367,262448,16936,7168,9768,112,196531936,195527088,1004848,68,173840,293232,4860,198168440,197346244,822196,56,21484,371444,4028
2025-07-30T18:18:46.799899,394700376,392877372,391591268,132,195324,664676,8888,34359738367,262448,16936,7168,9768,112,196531936,195529868,1002068,76,173840,293232,4860,198168440,197347504,820936,56,21484,371444,4028
2025-07-30T18:18:47.801031,394700376,392880940,391594840,104,195324,664676,8888,34359738367,262448,16936,7168,9768,112,196531936,195532428,999508,60,173840,293232,4860,198168440,197348512,819928,44,21484,371444,4028
2025-07-30T18:18:48.802144,394700376,392886664,391600564,104,195324,664676,8888,34359738367,262448,16936,7168,9768,112,196531936,195535884,996052,60,173840,293232,4860,198168440,197350780,817660,44,21484,371444,4028
2025-07-30T18:18:49.806781,394700376,392891200,391605100,104,195324,664676,8888,34359738367,262448,16936,7168,9768,112,196531936,195539160,992776,60,173840,293232,4860,198168440,197352040,816400,44,21484,371444,4028
2025-07-30T18:18:50.807909,394700376,392893908,391607808,112,195324,664676,8888,34359738367,262448,16936,7168,9768,112,196531936,195540848,991088,60,173840,293232,4860,198168440,197353060,815380,52,21484,371444,4028
2025-07-30T18:18:51.809074,394700376,392898352,391612252,144,195324,664676,8888,34359738367,262448,16936,7168,9768,112,196531936,195543276,988660,80,173840,293232,4860,198168440,197355076,813364,64,21484,371444,4028
2025-07-30T18:18:52.810237,394700376,392869372,391583272,144,195520,664704,9208,34359738367,262464,16936,7168,9768,112,196531936,195520848,1011088,80,173956,293260,5020,198168440,197348524,819916,64,21564,371444,4188
2025-07-30T18:18:53.814780,394700376,392857644,391571544,136,194552,664544,8756,34359738367,262464,16936,7168,9768,112,196531936,195508760,1023176,72,173452,293168,4780,198168440,197348884,819556,64,21100,371376,3976
2025-07-30T18:18:54.815927,394700376,392862096,391576048,140,195320,664676,8912,34359738367,262464,16936,7168,9768,112,196531936,195510024,1021912,76,173856,293232,4860,198168440,197352072,816368,64,21464,371444,4052
2025-07-30T18:18:55.817107,394700376,392866816,391580768,140,195320,664676,8912,34359738367,262464,16936,7168,9768,112,196531936,195512548,1019388,76,173856,293232,4860,198168440,197354268,814172,64,21464,371444,4052
2025-07-30T18:18:56.818284,394700376,392874224,391588176,148,195320,664676,8912,34359738367,262464,16936,7168,9768,112,196531936,195516964,1014972,80,173856,293232,4860,198168440,197357260,811180,68,21464,371444,4052
2025-07-30T18:18:57.822777,394700376,392882328,391596280,132,195420,664676,8912,34359738367,262464,16936,7168,9768,112,196531936,195521756,1010180,88,173956,293232,4860,198168440,197360572,807868,44,21464,371444,4052
2025-07-30T18:18:58.823915,394700376,392889752,391603704,140,195420,664676,8912,34359738367,262464,16936,7168,9768,112,196531936,195527520,1004416,92,173956,293232,4860,198168440,197362232,806208,48,21464,371444,4052
2025-07-30T18:18:59.825064,394700376,392896024,391609976,140,195420,664676,8912,34359738367,262464,16936,7168,9768,112,196531936,195532280,999656,92,173956,293232,4860,198168440,197363744,804696,48,21464,371444,4052
2025-07-30T18:19:00.826204,394700376,392901232,391615184,140,195420,664676,8912,34359738367,262464,16936,7168,9768,112,196531936,195535712,996224,92,173956,293232,4860,198168440,197365520,802920,48,21464,371444,4052
2025-07-30T18:19:01.830776,394700376,392903920,391617872,144,195424,664676,8912,34359738367,262464,16936,7168,9768,112,196531936,195537140,994796,96,173956,293232,4860,198168440,197366780,801660,48,21468,371444,4052
2025-07-30T18:19:02.831903,394700376,392894016,391608004,132,195480,664676,8964,34359738367,262480,16936,7168,9768,112,196531936,195538452,993484,68,174000,293232,4896,198168440,197355564,812876,64,21480,371444,4068
2025-07-30T18:19:03.833037,394700376,392894012,391607980,132,195104,664676,8612,34359738367,262512,16936,7168,9768,112,196531936,195537200,994736,68,173744,293232,4716,198168440,197356812,811628,64,21360,371444,3896
2025-07-30T18:19:04.834181,394700376,392894144,391608116,132,195428,664676,8892,34359738367,262512,16936,7168,9768,112,196531936,195537580,994356,68,173956,293232,4856,198168440,197356564,811876,64,21472,371444,4036
2025-07-30T18:19:05.838785,394700376,392897880,391611852,132,195428,664676,8892,34359738367,262512,16936,7168,9768,112,196531936,195540304,991632,68,173956,293232,4856,198168440,197357576,810864,64,21472,371444,4036
2025-07-30T18:19:06.839960,394700376,392902920,391616892,132,195428,664676,8892,34359738367,262512,16936,7168,9768,112,196531936,195543328,988608,68,173956,293232,4856,198168440,197359592,808848,64,21472,371444,4036
2025-07-30T18:19:07.841094,394700376,392904936,391618912,108,195428,664676,8892,34359738367,262512,16936,7168,9768,112,196531936,195543832,988104,60,173956,293232,4856,198168440,197361104,807336,48,21472,371444,4036
2025-07-30T18:19:08.842248,394700376,392909100,391623076,116,195428,664676,8892,34359738367,262512,16936,7168,9768,112,196531936,195545912,986024,64,173956,293232,4856,198168440,197363188,805252,52,21472,371444,4036
2025-07-30T18:19:09.844002,394700376,392915220,391629196,116,195428,664676,8892,34359738367,262512,16936,7168,9768,112,196531936,195548936,983000,64,173956,293232,4856,198168440,197366284,802156,52,21472,371444,4036
2025-07-30T18:19:10.846778,394700376,392918984,391632960,116,195428,664676,8892,34359738367,262512,16936,7168,9768,112,196531936,195549664,982272,64,173956,293232,4856,198168440,197369320,799120,52,21472,371444,4036
2025-07-30T18:19:11.847927,394700376,392921604,391635580,120,195428,664676,8892,34359738367,262512,16936,7168,9768,112,196531936,195551680,980256,68,173956,293232,4856,198168440,197369924,798516,52,21472,371444,4036
2025-07-30T18:19:12.849089,394700376,392913344,391627528,140,188244,123984,6776,34359738367,261312,16936,7168,9768,112,196531936,195547144,984792,80,170312,22936,3812,198168440,197366200,802240,60,17932,101048,2964
2025-07-30T18:19:13.849961,394700376,393444876,391895932,348,201896,133688,7892,34359738367,262528,16936,7168,9768,112,196531936,195804076,727860,232,181572,31824,4244,198168440,197640800,527640,116,20324,101864,3648
2025-07-30T18:19:14.850536,394700376,392768056,391375688,396,663416,134832,10044,34359738367,262496,16936,7168,9768,112,196531936,195408392,1123544,272,399600,32956,5540,198168440,197358152,810288,124,265288,101876,4504
2025-07-30T18:19:15.854765,394700376,391959896,390671304,396,1247792,134832,10044,34359738367,262496,16936,7168,9768,112,196531936,195117080,1414856,272,542932,32956,5540,198168440,196842816,1325624,124,704860,101876,4504
2025-07-30T18:19:16.855798,394700376,391958384,390671480,252,1255536,134832,10044,34359738367,262496,16936,7168,9768,112,196531936,195117080,1414856,172,545304,32956,5540,198168440,196841304,1327136,80,710232,101876,4504
2025-07-30T18:19:17.856837,394700376,391970300,390683396,252,1255536,134832,10044,34359738367,262496,16936,7168,9768,112,196531936,195122592,1409344,172,545304,32956,5540,198168440,196847708,1320732,80,710232,101876,4504
2025-07-30T18:19:18.857935,394700376,391972552,390685660,220,1255536,134832,10044,34359738367,262496,16936,7168,9768,112,196531936,195124088,1407848,156,545304,32956,5540,198168440,196848464,1319976,64,710232,101876,4504
2025-07-30T18:19:19.862769,394700376,391975340,390688448,300,1255536,134832,10044,34359738367,262496,16936,7168,9768,112,196531936,195125764,1406172,208,545304,32956,5540,198168440,196849576,1318864,92,710232,101876,4504
2025-07-30T18:19:20.863873,394700376,391983932,390697040,304,1255536,134832,10044,34359738367,262496,16936,7168,9768,112,196531936,195129544,1402392,212,545304,32956,5540,198168440,196854388,1314052,92,710232,101876,4504
2025-07-30T18:19:21.864985,394700376,391985724,390698832,304,1255536,134832,10044,34359738367,262496,16936,7168,9768,112,196531936,195130832,1401104,212,545304,32956,5540,198168440,196854892,1313548,92,710232,101876,4504
2025-07-30T18:19:22.866098,394700376,391987980,390701088,288,1255536,134832,10044,34359738367,262496,16936,7168,9768,112,196531936,195132080,1399856,196,545304,32956,5540,198168440,196855900,1312540,92,710232,101876,4504
2025-07-30T18:19:23.870770,394700376,392007124,390720264,288,1255552,134856,10216,34359738367,262608,16936,7168,9768,112,196531936,195139812,1392124,196,545204,32956,5552,198168440,196867312,1301128,92,710348,101900,4664
2025-07-30T18:19:24.871876,394700376,392009500,390722776,316,1255532,134832,10036,34359738367,262560,16936,7168,9768,112,196531936,195140572,1391364,216,545560,32956,5664,198168440,196868928,1299512,100,709972,101876,4372
2025-07-30T18:19:25.872971,394700376,392012512,390725788,328,1255532,134832,10036,34359738367,262560,16936,7168,9768,112,196531936,195142828,1389108,216,545560,32956,5664,198168440,196869684,1298756,112,709972,101876,4372
2025-07-30T18:19:26.874080,394700376,392018088,390731364,328,1255532,134832,10036,34359738367,262560,16936,7168,9768,112,196531936,195145800,1386136,216,545560,32956,5664,198168440,196872288,1296152,112,709972,101876,4372
2025-07-30T18:19:27.878768,394700376,392020424,390733700,328,1255532,134832,10036,34359738367,262560,16936,7168,9768,112,196531936,195146872,1385064,216,545560,32956,5664,198168440,196873552,1294888,112,709972,101876,4372
2025-07-30T18:19:28.879830,394700376,392023040,390736316,336,1255532,134832,10036,34359738367,262560,16936,7168,9768,112,196531936,195148480,1383456,216,545560,32956,5664,198168440,196874560,1293880,120,709972,101876,4372
2025-07-30T18:19:29.880936,394700376,392026524,390739800,344,1255592,134832,10036,34359738367,262560,16936,7168,9768,112,196531936,195150092,1381844,220,545560,32956,5664,198168440,196876432,1292008,124,710032,101876,4372
2025-07-30T18:19:30.882047,394700376,392028312,390741588,344,1255592,134832,10036,34359738367,262560,16936,7168,9768,112,196531936,195151124,1380812,220,545560,32956,5664,198168440,196877188,1291252,124,710032,101876,4372
2025-07-30T18:19:31.886762,394700376,392030328,390743604,344,1255592,134832,10036,34359738367,262560,16936,7168,9768,112,196531936,195152384,1379552,220,545560,32956,5664,198168440,196877944,1290496,124,710032,101876,4372
2025-07-30T18:19:32.887836,394700376,392032828,390746104,348,1255592,134832,10036,34359738367,262560,16936,7168,9768,112,196531936,195153572,1378364,220,545560,32956,5664,198168440,196879256,1289184,128,710032,101876,4372
2025-07-30T18:19:33.888955,394700376,392041144,390754420,324,1257160,134832,10068,34359738367,262592,16936,7168,9768,112,196531936,195159872,1372064,220,547128,32956,5696,198168440,196881272,1287168,104,710032,101876,4372
2025-07-30T18:19:34.890032,394700376,392046264,390759608,336,1255600,134832,10148,34359738367,262528,16936,7168,9768,112,196531936,195164316,1367620,232,545484,32956,5660,198168440,196881948,1286492,104,710116,101876,4488
2025-07-30T18:19:35.892283,394700376,392047936,390761280,336,1255600,134832,10040,34359738367,262528,16936,7168,9768,112,196531936,195164972,1366964,232,545484,32956,5600,198168440,196882964,1285476,104,710116,101876,4440
2025-07-30T18:19:36.894762,394700376,392049484,390762828,336,1255600,134832,10040,34359738367,262528,16936,7168,9768,112,196531936,195165728,1366208,232,545484,32956,5600,198168440,196883756,1284684,104,710116,101876,4440
2025-07-30T18:19:37.895868,394700376,392051404,390764748,348,1255600,134832,10040,34359738367,262528,16936,7168,9768,112,196531936,195166912,1365024,232,545484,32956,5600,198168440,196884492,1283948,116,710116,101876,4440
2025-07-30T18:19:38.898764,394700376,392052508,390765852,344,1255600,134832,10040,34359738367,262528,16936,7168,9768,112,196531936,195167504,1364432,232,545484,32956,5600,198168440,196885004,1283436,112,710116,101876,4440
2025-07-30T18:19:39.899860,394700376,392053516,390766860,348,1255600,134832,10040,34359738367,262528,16936,7168,9768,112,196531936,195168008,1363928,236,545484,32956,5600,198168440,196885508,1282932,112,710116,101876,4440
2025-07-30T18:19:40.900960,394700376,392055032,390768376,356,1255600,134832,10040,34359738367,262528,16936,7168,9768,112,196531936,195169020,1362916,240,545484,32956,5600,198168440,196886012,1282428,116,710116,101876,4440
2025-07-30T18:19:41.902028,394700376,392056040,390769384,356,1255600,134832,10040,34359738367,262528,16936,7168,9768,112,196531936,195169524,1362412,240,545484,32956,5600,198168440,196886516,1281924,116,710116,101876,4440
2025-07-30T18:19:42.904911,394700376,392056796,390770140,356,1255600,134832,10040,34359738367,262528,16936,7168,9768,112,196531936,195170028,1361908,240,545484,32956,5600,198168440,196886768,1281672,116,710116,101876,4440
2025-07-30T18:19:43.905958,394700376,392058532,390771876,324,1255600,134832,10040,34359738367,262544,16936,7168,9768,112,196531936,195170504,1361432,208,545484,32956,5600,198168440,196888028,1280412,116,710116,101876,4440
2025-07-30T18:19:44.910766,394700376,392059284,390772744,336,1255752,134832,10048,34359738367,262560,16936,7168,9768,112,196531936,195170976,1360960,220,545516,32956,5608,198168440,196888308,1280132,116,710236,101876,4440
2025-07-30T18:19:45.911827,394700376,392060492,390773952,260,1255752,134832,10048,34359738367,262560,16936,7168,9768,112,196531936,195171932,1360004,148,545516,32956,5608,198168440,196888560,1279880,112,710236,101876,4440
2025-07-30T18:19:46.912872,394700376,392061920,390775380,272,1255752,134832,10048,34359738367,262560,16936,7168,9768,112,196531936,195172580,1359356,160,545516,32956,5608,198168440,196889340,1279100,112,710236,101876,4440
2025-07-30T18:19:47.913934,394700376,392062992,390776452,272,1255752,134832,10048,34359738367,262560,16936,7168,9768,112,196531936,195173304,1358632,160,545516,32956,5608,198168440,196889688,1278752,112,710236,101876,4440
2025-07-30T18:19:48.918768,394700376,392063800,390777264,144,1255752,134832,10048,34359738367,262560,16936,7168,9768,112,196531936,195173808,1358128,88,545516,32956,5608,198168440,196889992,1278448,56,710236,101876,4440
2025-07-30T18:19:49.919821,394700376,392065092,390778556,164,1255752,134832,10048,34359738367,262560,16936,7168,9768,112,196531936,195174564,1357372,92,545516,32956,5608,198168440,196890528,1277912,72,710236,101876,4440
2025-07-30T18:19:50.920913,394700376,392065344,390778808,88,1255752,134832,10048,34359738367,262560,16936,7168,9768,112,196531936,195174816,1357120,48,545516,32956,5608,198168440,196890528,1277912,40,710236,101876,4440
2025-07-30T18:19:51.921991,394700376,392066104,390779568,92,1255752,134832,10048,34359738367,262560,16936,7168,9768,112,196531936,195175324,1356612,48,545516,32956,5608,198168440,196890780,1277660,44,710236,101876,4440
2025-07-30T18:19:52.926767,394700376,392067080,390780544,92,1255752,134832,10048,34359738367,262560,16936,7168,9768,112,196531936,195175796,1356140,48,545516,32956,5608,198168440,196891284,1277156,44,710236,101876,4440
2025-07-30T18:19:53.927830,394700376,392066324,390779788,92,1255752,134832,10048,34359738367,262592,16936,7168,9768,112,196531936,195175040,1356896,48,545516,32956,5608,198168440,196891284,1277156,44,710236,101876,4440
2025-07-30T18:19:54.928922,394700376,392068076,390781576,104,1255748,134832,10252,34359738367,262608,16936,7168,9768,112,196531936,195176068,1355868,56,545516,32956,5660,198168440,196892008,1276432,48,710232,101876,4592
2025-07-30T18:19:55.929999,394700376,392068596,390782096,108,1255748,134832,10040,34359738367,262608,16936,7168,9768,112,196531936,195176320,1355616,60,545516,32956,5600,198168440,196892276,1276164,48,710232,101876,4440
2025-07-30T18:19:56.934763,394700376,392069108,390782608,116,1255748,134832,10040,34359738367,262608,16936,7168,9768,112,196531936,195176832,1355104,68,545516,32956,5600,198168440,196892276,1276164,48,710232,101876,4440
2025-07-30T18:19:57.935881,394700376,392070316,390783816,120,1255748,134832,10040,34359738367,262608,16936,7168,9768,112,196531936,195177552,1354384,72,545516,32956,5600,198168440,196892764,1275676,48,710232,101876,4440
2025-07-30T18:19:58.936972,394700376,392070712,390784212,120,1255748,134832,10040,34359738367,262608,16936,7168,9768,112,196531936,195177804,1354132,72,545516,32956,5600,198168440,196892908,1275532,48,710232,101876,4440
2025-07-30T18:19:59.938041,394700376,392070964,390784484,120,1255820,134832,10040,34359738367,262608,16936,7168,9768,112,196531936,195178056,1353880,68,545584,32956,5600,198168440,196892908,1275532,52,710236,101876,4440
2025-07-30T18:20:00.942765,394700376,392071716,390785236,136,1255820,134832,10040,34359738367,262608,16936,7168,9768,112,196531936,195178556,1353380,76,545584,32956,5600,198168440,196893160,1275280,60,710236,101876,4440
2025-07-30T18:20:01.943825,394700376,392071968,390785488,152,1255820,134832,10040,34359738367,262592,16936,7168,9768,112,196531936,195178808,1353128,84,545584,32956,5600,198168440,196893160,1275280,68,710236,101876,4440
2025-07-30T18:20:02.944920,394700376,392072472,390785992,152,1255820,134832,10040,34359738367,262592,16936,7168,9768,112,196531936,195179312,1352624,84,545584,32956,5600,198168440,196893160,1275280,68,710236,101876,4440
2025-07-30T18:20:03.945983,394700376,392071968,390785488,152,1255820,134832,10040,34359738367,262576,16936,7168,9768,112,196531936,195179564,1352372,84,545584,32956,5600,198168440,196892404,1276036,68,710236,101876,4440
2025-07-30T18:20:04.948184,394700376,392071908,390785432,152,1256100,135212,10256,34359738367,262576,16936,7168,9768,112,196531936,195179848,1352088,84,545424,32976,5568,198168440,196892060,1276380,68,710676,102236,4688
2025-07-30T18:20:05.949281,394700376,392072176,390785700,160,1255820,134832,10040,34359738367,262576,16936,7168,9768,112,196531936,195180116,1351820,88,545404,32956,5560,198168440,196892060,1276380,72,710416,101876,4480
2025-07-30T18:20:06.950399,394700376,392072932,390786456,160,1255820,134832,10040,34359738367,262576,16936,7168,9768,112,196531936,195180620,1351316,88,545404,32956,5560,198168440,196892312,1276128,72,710416,101876,4480
2025-07-30T18:20:07.954768,394700376,392073388,390786912,168,1255820,134832,10040,34359738367,262576,16936,7168,9768,112,196531936,195181072,1350864,96,545404,32956,5560,198168440,196892316,1276124,72,710416,101876,4480
2025-07-30T18:20:08.955877,394700376,392073724,390787248,168,1255820,134832,10040,34359738367,262576,16936,7168,9768,112,196531936,195181324,1350612,96,545404,32956,5560,198168440,196892400,1276040,72,710416,101876,4480
2025-07-30T18:20:09.956944,394700376,392074228,390787764,136,1255820,134832,10040,34359738367,262576,16936,7168,9768,112,196531936,195181576,1350360,96,545404,32956,5560,198168440,196892652,1275788,40,710416,101876,4480
2025-07-30T18:20:10.958083,394700376,392074732,390788268,140,1255820,134832,10040,34359738367,262576,16936,7168,9768,112,196531936,195182080,1349856,96,545404,32956,5560,198168440,196892652,1275788,44,710416,101876,4480
2025-07-30T18:20:11.961138,394700376,392074984,390788520,140,1255820,134832,10040,34359738367,262576,16936,7168,9768,112,196531936,195182332,1349604,96,545404,32956,5560,198168440,196892652,1275788,44,710416,101876,4480
2025-07-30T18:20:12.962225,394700376,392075488,390789024,176,1255820,134832,10040,34359738367,262576,16936,7168,9768,112,196531936,195182584,1349352,112,545404,32956,5560,198168440,196892904,1275536,64,710416,101876,4480
2025-07-30T18:20:13.966767,394700376,392074480,390788016,176,1255820,134832,10040,34359738367,262560,16936,7168,9768,112,196531936,195181576,1350360,112,545404,32956,5560,198168440,196892904,1275536,64,710416,101876,4480
2025-07-30T18:20:14.967817,394700376,392074512,390788048,188,1255968,134832,10296,34359738367,262544,16936,7168,9768,112,196531936,195181656,1350280,112,545492,32956,5604,198168440,196892856,1275584,76,710476,101876,4692
2025-07-30T18:20:15.968921,394700376,392075160,390788700,188,1255820,134832,10044,34359738367,262544,16936,7168,9768,112,196531936,195182008,1349928,112,545592,32956,5672,198168440,196893152,1275288,76,710228,101876,4372
2025-07-30T18:20:16.969979,394700376,392075720,390789260,192,1255852,134832,10044,34359738367,262544,16936,7168,9768,112,196531936,195182568,1349368,116,545624,32956,5672,198168440,196893152,1275288,76,710228,101876,4372
2025-07-30T18:20:17.974763,394700376,392075988,390789528,192,1255852,134832,10044,34359738367,262544,16936,7168,9768,112,196531936,195182680,1349256,116,545624,32956,5672,198168440,196893308,1275132,76,710228,101876,4372
2025-07-30T18:20:18.975812,394700376,392076592,390790148,204,1255852,134832,10044,34359738367,262544,16936,7168,9768,112,196531936,195182940,1348996,128,545624,32956,5672,198168440,196893652,1274788,76,710228,101876,4372
2025-07-30T18:20:19.976859,394700376,392077100,390790672,140,1255852,134832,10044,34359738367,262544,16936,7168,9768,112,196531936,195183444,1348492,76,545624,32956,5672,198168440,196893656,1274784,64,710228,101876,4372
2025-07-30T18:20:20.977928,394700376,392077100,390790672,140,1255852,134832,10044,34359738367,262544,16936,7168,9768,112,196531936,195183444,1348492,76,545624,32956,5672,198168440,196893656,1274784,64,710228,101876,4372
2025-07-30T18:20:21.982764,394700376,392077604,390791176,76,1255852,134832,10044,34359738367,262544,16936,7168,9768,112,196531936,195183696,1348240,32,545624,32956,5672,198168440,196893908,1274532,44,710228,101876,4372
2025-07-30T18:20:22.983819,394700376,392077616,390791188,112,1255852,134832,10044,34359738367,262544,16936,7168,9768,112,196531936,195183708,1348228,56,545624,32956,5672,198168440,196893908,1274532,56,710228,101876,4372
2025-07-30T18:20:23.984888,394700376,392077616,390791188,112,1255852,134832,10044,34359738367,262496,16936,7168,9768,112,196531936,195183708,1348228,56,545624,32956,5672,198168440,196893908,1274532,56,710228,101876,4372
2025-07-30T18:20:24.985962,394700376,392076360,390789956,116,1255916,134832,10112,34359738367,262496,16936,7168,9768,112,196531936,195183600,1348336,56,545684,32956,5740,198168440,196892760,1275680,60,710232,101876,4372
2025-07-30T18:20:25.990765,394700376,392076564,390790160,124,1255848,134832,10048,34359738367,262496,16936,7168,9768,112,196531936,195184076,1347860,60,545584,32956,5608,198168440,196892488,1275952,64,710264,101876,4440
2025-07-30T18:20:26.991864,394700376,392076616,390790212,124,1255848,134832,10048,34359738367,262496,16936,7168,9768,112,196531936,195184076,1347860,60,545584,32956,5608,198168440,196892540,1275900,64,710264,101876,4440
2025-07-30T18:20:27.992946,394700376,392077288,390790884,128,1255848,134832,10048,34359738367,262496,16936,7168,9768,112,196531936,195184448,1347488,64,545584,32956,5608,198168440,196892840,1275600,64,710264,101876,4440
2025-07-30T18:20:28.994048,394700376,392078040,390791636,132,1255848,134832,10048,34359738367,262496,16936,7168,9768,112,196531936,195185056,1346880,64,545584,32956,5608,198168440,196892984,1275456,68,710264,101876,4440
2025-07-30T18:20:29.998774,394700376,392078040,390791696,108,1255976,134832,10048,34359738367,262496,16936,7168,9768,112,196531936,195185056,1346880,64,545652,32956,5608,198168440,196892984,1275456,44,710324,101876,4440
2025-07-30T18:20:30.999894,394700376,392078548,390792204,112,1255976,134832,10048,34359738367,262496,16936,7168,9768,112,196531936,195185312,1346624,68,545652,32956,5608,198168440,196893236,1275204,44,710324,101876,4440
2025-07-30T18:20:32.000969,394700376,392078580,390792236,112,1255976,134832,10048,34359738367,262496,16936,7168,9768,112,196531936,195185344,1346592,68,545652,32956,5608,198168440,196893236,1275204,44,710324,101876,4440
2025-07-30T18:20:33.002082,394700376,392078580,390792236,112,1255976,134832,10048,34359738367,262496,16936,7168,9768,112,196531936,195185344,1346592,68,545652,32956,5608,198168440,196893236,1275204,44,710324,101876,4440
2025-07-30T18:20:34.006763,394700376,392078956,390792612,112,1255976,134832,10048,34359738367,262560,16936,7168,9768,112,196531936,195185468,1346468,68,545652,32956,5608,198168440,196893488,1274952,44,710324,101876,4440
2025-07-30T18:20:35.007811,394700376,392077788,390791444,108,1256360,134932,10384,34359738367,262528,16936,7168,9768,112,196531936,195184804,1347132,60,545864,33084,5796,198168440,196892984,1275456,48,710496,101848,4588
2025-07-30T18:20:36.008920,394700376,392077960,390791620,120,1255980,134832,10044,34359738367,262528,16936,7168,9768,112,196531936,195185016,1346920,68,545652,32956,5540,198168440,196892944,1275496,52,710328,101876,4504
2025-07-30T18:20:37.009980,394700376,392078212,390791872,128,1255980,134832,10044,34359738367,262528,16936,7168,9768,112,196531936,195185016,1346920,68,545652,32956,5540,198168440,196893196,1275244,60,710328,101876,4504
2025-07-30T18:20:38.014762,394700376,392078524,390792184,132,1255980,134832,10044,34359738367,262528,16936,7168,9768,112,196531936,195185160,1346776,68,545652,32956,5540,198168440,196893364,1275076,64,710328,101876,4504
2025-07-30T18:20:39.015875,394700376,392078788,390792448,132,1255980,134832,10044,34359738367,262528,16936,7168,9768,112,196531936,195185348,1346588,68,545652,32956,5540,198168440,196893440,1275000,64,710328,101876,4504
2025-07-30T18:20:40.016975,394700376,392079040,390792700,132,1255980,134832,10044,34359738367,262528,16936,7168,9768,112,196531936,195185348,1346588,68,545652,32956,5540,198168440,196893692,1274748,64,710328,101876,4504
2025-07-30T18:20:41.018100,394700376,392079040,390792728,136,1255980,134832,10044,34359738367,262528,16936,7168,9768,112,196531936,195185348,1346588,80,545652,32956,5540,198168440,196893692,1274748,56,710328,101876,4504
2025-07-30T18:20:42.022764,394700376,392079040,390792728,140,1255980,134832,10044,34359738367,262528,16936,7168,9768,112,196531936,195185348,1346588,84,545652,32956,5540,198168440,196893692,1274748,56,710328,101876,4504
2025-07-30T18:20:43.023814,394700376,392079152,390792840,140,1255980,134832,10044,34359738367,262528,16936,7168,9768,112,196531936,195185348,1346588,84,545652,32956,5540,198168440,196893804,1274636,56,710328,101876,4504
2025-07-30T18:20:44.024911,394700376,392078648,390792336,152,1255980,134832,10044,34359738367,262512,16936,7168,9768,112,196531936,195185348,1346588,92,545652,32956,5540,198168440,196893300,1275140,60,710328,101876,4504
2025-07-30T18:20:45.026001,394700376,392077104,390790840,168,1255984,134832,10040,34359738367,262544,16936,7168,9768,112,196531936,195183940,1347996,104,545696,32956,5604,198168440,196893164,1275276,64,710288,101876,4436
2025-07-30T18:20:46.030762,394700376,392077460,390791204,140,1255988,134832,10040,34359738367,262544,16936,7168,9768,112,196531936,195184356,1347580,104,545700,32956,5604,198168440,196893104,1275336,36,710288,101876,4436
2025-07-30T18:20:47.031815,394700376,392077476,390791220,140,1255988,134832,10040,34359738367,262544,16936,7168,9768,112,196531936,195184372,1347564,104,545700,32956,5604,198168440,196893104,1275336,36,710288,101876,4436
2025-07-30T18:20:48.032898,394700376,392077908,390791652,148,1255988,134832,10040,34359738367,262544,16936,7168,9768,112,196531936,195184644,1347292,108,545700,32956,5604,198168440,196893264,1275176,40,710288,101876,4436
2025-07-30T18:20:49.034019,394700376,392078012,390791756,160,1256020,134832,10040,34359738367,262544,16936,7168,9768,112,196531936,195184708,1347228,108,545732,32956,5604,198168440,196893304,1275136,52,710288,101876,4436
2025-07-30T18:20:50.038765,394700376,392078012,390791756,160,1256020,134832,10040,34359738367,262544,16936,7168,9768,112,196531936,195184708,1347228,108,545732,32956,5604,198168440,196893304,1275136,52,710288,101876,4436
2025-07-30T18:20:51.039844,394700376,392078012,390791760,140,1256020,134832,10040,34359738367,262544,16936,7168,9768,112,196531936,195184708,1347228,88,545732,32956,5604,198168440,196893304,1275136,52,710288,101876,4436
2025-07-30T18:20:52.040906,394700376,392078012,390791760,140,1256020,134832,10040,34359738367,262544,16936,7168,9768,112,196531936,195184708,1347228,88,545732,32956,5604,198168440,196893304,1275136,52,710288,101876,4436
2025-07-30T18:20:53.042010,394700376,392078012,390791760,140,1256020,134832,10040,34359738367,262544,16936,7168,9768,112,196531936,195184708,1347228,88,545732,32956,5604,198168440,196893304,1275136,52,710288,101876,4436
2025-07-30T18:20:54.046766,394700376,392077508,390791276,116,1256020,134832,10040,34359738367,262560,16936,7168,9768,112,196531936,195184204,1347732,80,545732,32956,5604,198168440,196893304,1275136,36,710288,101876,4436
2025-07-30T18:20:55.047845,394700376,392078968,390792756,116,1256016,134832,10036,34359738367,262544,16936,7168,9768,112,196531936,195184220,1347716,80,545708,32956,5600,198168440,196894748,1273692,36,710308,101876,4436
2025-07-30T18:20:56.048900,394700376,392079368,390793160,92,1256012,134832,10036,34359738367,262544,16936,7168,9768,112,196531936,195184488,1347448,56,545708,32956,5600,198168440,196894880,1273560,36,710304,101876,4436
2025-07-30T18:20:57.049987,394700376,392079420,390793212,92,1256012,134832,10036,34359738367,262544,16936,7168,9768,112,196531936,195184488,1347448,56,545708,32956,5600,198168440,196894932,1273508,36,710304,101876,4436
2025-07-30T18:20:58.054768,394700376,392079744,390793536,92,1256012,134832,10036,34359738367,262544,16936,7168,9768,112,196531936,195184668,1347268,56,545708,32956,5600,198168440,196895076,1273364,36,710304,101876,4436
2025-07-30T18:20:59.055820,394700376,392079884,390793676,104,1256012,134832,10036,34359738367,262544,16936,7168,9768,112,196531936,195184800,1347136,64,545708,32956,5600,198168440,196895084,1273356,40,710304,101876,4436
2025-07-30T18:21:00.056892,394700376,392079392,390793184,124,1256012,134832,10036,34359738367,262544,16936,7168,9768,112,196531936,195184560,1347376,76,545708,32956,5600,198168440,196894832,1273608,48,710304,101876,4436
2025-07-30T18:21:01.057966,394700376,392079392,390793192,136,1256012,134832,10036,34359738367,262544,16936,7168,9768,112,196531936,195184560,1347376,88,545708,32956,5600,198168440,196894832,1273608,48,710304,101876,4436
2025-07-30T18:21:02.062770,394700376,392079392,390793192,136,1256012,134832,10036,34359738367,262544,16936,7168,9768,112,196531936,195184560,1347376,88,545708,32956,5600,198168440,196894832,1273608,48,710304,101876,4436
2025-07-30T18:21:03.063837,394700376,392079392,390793192,136,1256012,134832,10036,34359738367,262544,16936,7168,9768,112,196531936,195184560,1347376,88,545708,32956,5600,198168440,196894832,1273608,48,710304,101876,4436
2025-07-30T18:21:04.064950,394700376,392078384,390792184,136,1256012,134832,10036,34359738367,262592,16936,7168,9768,112,196531936,195184056,1347880,88,545708,32956,5600,198168440,196894328,1274112,48,710304,101876,4436
2025-07-30T18:21:05.066032,394700376,392079064,390792876,140,1255960,134832,9980,34359738367,262544,16936,7168,9768,112,196531936,195183928,1348008,92,545556,32956,5476,198168440,196895136,1273304,48,710404,101876,4504
2025-07-30T18:21:06.070768,394700376,392079388,390793200,124,1256012,134832,10048,34359738367,262544,16936,7168,9768,112,196531936,195183996,1347940,80,545608,32956,5540,198168440,196895392,1273048,44,710404,101876,4508
2025-07-30T18:21:07.071852,394700376,392079456,390793268,128,1256012,134832,10048,34359738367,262544,16936,7168,9768,112,196531936,195184052,1347884,84,545608,32956,5540,198168440,196895404,1273036,44,710404,101876,4508
2025-07-30T18:21:08.072961,394700376,392079720,390793532,128,1256012,134832,10048,34359738367,262544,16936,7168,9768,112,196531936,195184196,1347740,84,545608,32956,5540,198168440,196895524,1272916,44,710404,101876,4508
2025-07-30T18:21:09.074028,394700376,392079784,390793596,128,1256012,134832,10048,34359738367,262544,16936,7168,9768,112,196531936,195184260,1347676,84,545608,32956,5540,198168440,196895524,1272916,44,710404,101876,4508
2025-07-30T18:21:10.078765,394700376,392079784,390793596,132,1256012,134832,10048,34359738367,262544,16936,7168,9768,112,196531936,195184260,1347676,84,545608,32956,5540,198168440,196895524,1272916,48,710404,101876,4508
2025-07-30T18:21:11.079831,394700376,392079784,390793600,136,1256012,134832,10048,34359738367,262544,16936,7168,9768,112,196531936,195184260,1347676,88,545608,32956,5540,198168440,196895524,1272916,48,710404,101876,4508
2025-07-30T18:21:12.080914,394700376,392079784,390793600,144,1256012,134832,10048,34359738367,262544,16936,7168,9768,112,196531936,195184260,1347676,88,545608,32956,5540,198168440,196895524,1272916,56,710404,101876,4508
2025-07-30T18:21:13.081967,394700376,392079784,390793600,156,1256012,134832,10048,34359738367,262544,16936,7168,9768,112,196531936,195184260,1347676,100,545608,32956,5540,198168440,196895524,1272916,56,710404,101876,4508
2025-07-30T18:21:14.083107,394700376,393137680,391851496,156,192068,124752,7528,34359738367,261360,16936,7168,9768,112,196531936,195559740,972196,100,172144,22876,4028,198168440,197577940,590500,56,19924,101876,3500
2025-07-30T18:21:15.083687,394700376,393169448,391883520,172,187504,123468,10860,34359738367,261712,16936,7168,9768,112,196531936,195568892,963044,116,169912,22320,4896,198168440,197599532,568908,56,17592,101148,5964
